[
    ["x","x","x","x","x"," "," "," "," ","x","x","x","x","x","x","x","x","x","x","x"],
    ["x","e"," "," ","x"," "," "," "," ","x"," "," "," "," "," "," "," "," "," ","x"],
    ["x"," "," "," ","x"," "," "," "," ","x"," "," "," "," "," "," "," "," "," ","x"],
    ["x"," "," "," ","x"," "," "," "," ","x"," "," "," ","x"," "," "," "," "," ","x"],
    ["x"," "," "," ","x","x","x","x","x","x"," "," "," ","x"," "," "," "," "," ","x"],
    ["x"," "," "," "," "," "," "," "," ","x"," "," "," ","x"," "," "," "," "," ","x"],
    ["x"," ","p"," "," "," "," "," "," ","x"," "," "," ","x"," "," ","e"," "," ","x"],
    ["x"," "," "," "," "," "," "," "," ","x"," "," "," ","x"," "," "," "," "," ","x"],
    ["x"," "," "," ","w"," "," "," "," ","x"," "," "," ","x"," "," "," "," "," ","x"],
    ["x","d"," "," "," "," "," "," "," ","x"," "," "," ","x"," "," "," "," "," ","x","x","x"],
    ["x","x","x","x","x","x"," ","e"," ","x"," "," ","e","x"," ","x"," "," "," "," "],
    ["x"," "," "," "," "," "," "," "," "," "," "," "," ","x"," ","x"," ","e"," "," "],
    ["x"," "," "," "," "," "," "," "," "," "," "," "," ","x"," ","x"," "," "," ","x","x","x"],
    ["x"," "," "," "," "," "," "," "," "," "," "," "," ","x"," ","x","x","x","x","x"],
    ["x","e"," "," "," "," "," "," "," "," "," "," ","e","x","e","x"," "," "," ","x"],
    ["x","x","x","x","x"," "," "," "," "," ","x","x","x","x","x","x"," "," "," "," "],
    [" "," "," "," ","x"," "," "," "," "," "," "," ","e","x"," "," "," "," "," "," "],
    [" "," "," "," ","x","x","x","x","x","x","x","x","x","x"," "," "," "," "," "," "]
]
