[
    ["x","x","x","x","x"," "," "," "," ","x","x","x","x","x","x","x","x","x","x","x"],
    ["x","i"," "," ","x"," "," "," "," ","x"," "," "," "," "," "," "," "," "," ","x"],
    ["x"," "," "," ","x"," "," "," "," ","x"," "," "," "," "," "," "," "," "," ","x"],
    ["x"," "," "," ","x"," "," "," "," ","x"," "," "," ","x"," "," "," "," "," ","x"],
    ["x"," "," "," ","x","x","x","x","x","x"," "," "," ","x"," "," "," "," "," ","x"],
    ["x"," "," "," "," "," "," "," "," ","x"," "," "," ","x"," "," "," "," "," ","x"],
    ["x"," ","p"," "," "," "," "," "," ","x"," "," "," ","x"," "," ","i"," "," ","x"],
    ["x"," "," "," "," "," "," "," "," ","x"," "," "," ","x"," "," "," "," "," ","x"],
    ["x"," "," "," "," "," "," "," "," ","x"," "," "," ","x"," "," "," "," "," ","x"],
    ["x"," "," "," "," "," "," "," "," ","x"," "," "," ","x"," "," "," "," "," ","x","x","x"],
    ["x","x","x","x","x","x"," ","i"," ","x"," "," ","i","x"," ","x"," "," "," "," "],
    ["x"," "," "," "," "," "," "," "," "," "," "," "," ","x"," ","x"," ","i"," "," "],
    ["x"," "," "," "," "," "," "," "," "," "," "," "," ","x"," ","x"," "," "," ","x","x","x"],
    ["x"," "," "," "," "," "," "," "," "," "," "," "," ","x"," ","x","x","x","x","x"],
    ["x","i"," "," "," "," "," "," "," "," "," "," ","i","x","i","x"," "," "," ","x"],
    ["x","x","x","x","x"," "," "," "," "," ","x","x","x","x","x","x"," "," "," "," "],
    [" "," "," "," ","x"," "," "," "," "," "," "," ","i","x"," "," "," "," "," "," "],
    [" "," "," "," ","x","x","x","x","x","x","x","x","x","x"," "," "," "," "," "," "]
]
