34,34,34,34,34,34,34,34,34,34,34,34,34,34,34,34,34,34,34,34,34,34,34,34,34,34,34,34,34,34,34,34,34,34,34,34,34,34,34,34,34,34,34,34,34,34,34,34,34,34,34,34,34,34,34,34,34,34,34,34,34,34,34,34,34,34,34,34,34,34,34,34,34,34,34,34,34,34,34,34
34,34,34,34,34,34,34,34,34,34,34,34,34,34,34,34,34,34,34,34,34,34,34,34,34,34,34,34,34,34,34,34,34,34,34,34,34,34,34,34,34,34,34,34,34,34,34,34,34,34,34,34,34,34,34,34,34,34,34,34,34,34,34,34,34,34,34,34,34,34,34,34,34,34,34,34,34,34,34,34
34,34,34,34,34,34,34,34,34,34,34,34,34,34,34,34,34,34,34,34,34,34,34,34,34,34,34,34,34,34,34,34,34,34,34,34,34,34,34,34,34,34,34,34,34,34,34,34,34,34,34,34,34,34,34,34,34,34,34,34,34,34,34,34,34,34,34,34,34,34,34,34,34,34,34,34,34,34,34,34
34,34,34,34,34,34,34,34,34,34,34,34,34,34,34,34,34,34,34,34,34,34,34,34,34,34,34,34,34,34,34,34,34,34,34,34,34,34,34,34,34,34,34,34,34,34,34,34,34,34,34,34,34,34,34,34,34,34,34,34,34,34,34,34,34,34,34,34,34,34,34,34,34,34,34,34,34,34,34,34
34,34,34,34,34,34,34,34,34,34,34,34,34,34,34,34,34,34,34,34,34,34,34,34,34,34,34,34,34,34,34,34,34,34,34,34,34,34,34,34,34,34,34,34,34,34,34,34,34,34,34,34,34,34,34,34,34,34,34,34,34,34,34,34,34,34,34,34,34,34,34,34,34,34,34,34,34,34,34,34
34,34,34,34,34,34,34,34,34,34,34,34,34,34,34,34,34,34,34,34,34,34,34,34,34,34,34,34,34,34,34,34,34,34,34,34,34,34,34,34,34,34,34,34,34,34,34,34,34,34,34,34,34,34,34,34,34,34,34,34,34,34,34,34,34,34,34,34,34,34,34,34,34,34,34,34,34,34,34,34
34,34,34,34,34,34,34,34,34,34,34,34,34,34,34,34,34,34,34,34,34,34,34,34,34,34,34,34,34,34,34,34,34,34,34,34,34,34,34,34,34,34,34,34,34,34,34,34,34,34,34,34,34,34,34,34,34,34,34,34,34,34,34,34,34,34,34,34,34,34,34,34,34,34,34,34,34,34,34,34
34,34,34,34,34,34,34,34,34,34,34,34,34,34,34,34,34,34,34,34,34,34,34,34,34,34,34,34,34,34,34,34,34,34,34,34,34,34,34,34,34,34,34,34,34,34,34,34,34,34,34,34,34,34,34,34,34,34,34,34,34,34,34,34,34,34,34,34,34,34,34,34,34,34,34,34,34,34,34,34
34,34,34,34,34,34,34,34,34,34,34,34,34,34,34,34,34,34,34,34,34,34,34,34,34,34,34,34,34,34,34,34,34,34,34,34,34,34,34,34,34,34,34,34,34,34,34,34,34,34,34,34,34,34,34,34,34,34,34,34,34,34,34,34,34,34,34,34,34,34,34,34,34,34,34,34,34,34,34,34
34,34,34,34,34,34,34,34,34,34,34,34,34,34,34,34,34,34,34,34,34,34,34,34,34,34,34,34,34,34,34,34,34,34,34,34,34,34,34,34,34,34,34,34,34,34,34,34,34,34,34,34,34,34,34,34,34,34,34,34,34,34,34,34,34,34,34,34,34,34,34,34,34,34,34,34,34,34,34,34
34,34,34,34,34,34,34,34,34,34,34,34,34,34,34,34,34,34,34,34,34,34,34,34,34,34,34,34,34,34,34,34,34,34,34,34,34,34,34,34,34,34,34,34,34,34,34,34,34,34,34,34,34,34,34,34,34,34,34,34,34,34,34,34,34,34,34,34,34,34,34,34,34,34,34,34,34,34,34,34
34,34,34,34,34,34,34,34,34,34,34,34,34,34,34,34,34,34,34,34,34,34,34,34,34,34,34,34,34,34,34,34,34,34,34,34,34,34,271,271,271,271,271,34,34,34,34,34,34,34,34,34,34,34,34,34,34,34,34,34,34,34,34,34,34,34,34,34,34,34,34,34,34,34,34,34,34,34,34,34
34,34,34,34,34,34,34,34,34,34,34,34,34,34,34,34,34,34,34,34,34,34,34,34,34,34,34,34,34,34,34,34,34,34,34,34,34,34,34,34,34,34,34,34,34,34,34,34,34,34,34,34,34,34,34,34,34,34,34,34,34,34,34,34,34,34,34,34,34,34,34,34,34,34,34,34,34,34,34,34
34,34,34,34,34,34,34,34,34,34,34,34,34,34,34,34,34,34,34,34,34,34,34,34,34,34,34,34,34,34,34,34,34,34,34,34,34,34,34,34,34,34,34,34,34,34,34,34,34,34,34,34,34,34,34,34,34,34,34,34,34,34,34,34,34,34,34,34,34,34,34,34,34,34,34,34,34,34,34,34
34,34,34,34,34,34,34,34,34,34,34,34,34,34,34,34,34,34,34,34,34,34,34,271,271,271,271,34,34,34,34,34,34,34,34,34,34,34,34,34,34,271,271,271,271,271,271,34,34,34,34,34,34,34,34,34,34,34,34,34,34,34,34,34,34,34,34,34,34,34,34,34,34,34,34,34,34,34,34,34
34,34,34,34,34,34,34,34,34,34,34,34,34,34,34,34,34,34,34,34,34,34,34,34,34,34,34,34,34,34,34,34,34,34,34,34,34,34,34,34,271,271,34,34,34,34,34,34,34,34,34,271,271,34,34,34,34,34,34,34,34,34,34,34,34,34,34,34,34,34,34,34,34,34,34,34,34,34,34,34
166,166,166,166,166,166,166,166,166,166,166,271,166,166,166,166,166,166,166,166,166,166,166,166,166,166,166,166,166,166,166,166,274,274,274,274,274,274,274,274,274,274,274,274,274,274,274,286,287,287,288,274,271,271,271,274,274,274,274,274,274,274,274,274,166,166,166,166,166,166,166,166,166,166,166,166,166,166,166,166
166,166,166,166,166,166,166,166,166,166,166,271,166,166,166,166,166,166,166,166,166,166,166,166,286,287,287,287,287,287,287,287,288,274,274,274,274,274,274,274,274,274,274,274,274,274,274,308,309,309,310,274,274,274,274,274,274,274,252,274,274,271,271,271,271,166,166,166,166,166,166,166,166,166,166,166,166,166,166,166
166,166,166,166,166,166,166,166,166,166,271,271,166,166,166,166,166,166,166,166,166,166,166,166,308,309,309,309,309,309,309,309,310,274,274,274,272,274,274,271,274,274,274,274,274,274,274,308,309,309,310,274,274,274,274,274,274,274,274,274,274,274,274,274,166,271,271,271,166,166,166,252,166,166,166,166,166,166,166,166
166,166,166,166,166,166,166,166,166,166,271,166,166,166,166,166,166,166,166,166,166,166,166,166,308,309,309,309,309,309,309,309,310,274,271,272,272,274,274,271,271,274,274,274,274,274,274,308,309,309,310,274,274,274,274,274,274,274,274,274,274,274,274,274,166,166,166,166,166,166,166,166,166,166,166,166,166,166,166,166
166,166,166,166,166,166,166,166,166,166,271,166,166,166,166,166,166,166,272,272,272,166,166,166,330,331,331,331,331,309,309,309,310,271,272,272,274,274,274,274,271,274,286,287,287,287,287,309,309,309,309,287,287,287,287,287,287,287,287,287,287,287,287,287,287,287,287,287,287,287,288,166,166,166,166,166,166,166,166,166
166,166,166,166,166,166,166,166,166,166,272,166,166,166,166,166,166,166,252,166,272,272,272,252,166,166,166,166,166,308,309,309,310,271,272,274,274,274,274,274,274,274,308,309,309,309,309,309,309,309,309,309,309,309,309,309,309,309,309,309,309,309,309,309,309,309,309,309,309,309,310,166,166,166,166,166,166,166,166,166
166,166,166,166,166,166,166,166,166,272,166,166,166,166,166,166,166,166,166,166,166,270,270,166,270,270,270,166,166,308,309,309,310,274,272,274,274,274,252,274,274,274,308,309,309,309,309,309,309,309,309,309,309,309,309,309,309,309,309,309,309,309,309,309,309,309,309,309,309,309,310,166,166,166,166,166,166,166,166,166
166,166,166,166,166,166,166,166,166,272,166,166,166,166,166,166,166,166,166,166,166,166,270,270,166,166,270,166,166,308,309,309,310,274,270,270,274,274,274,274,274,274,308,309,309,309,331,331,331,331,331,331,331,331,331,331,331,331,309,309,309,309,331,331,331,331,331,331,331,331,332,166,166,166,166,166,166,166,166,166
166,166,166,166,166,166,166,166,252,272,166,166,166,166,286,287,287,287,287,287,287,287,288,166,166,166,166,166,166,308,309,309,310,274,270,274,274,286,287,287,287,287,309,309,309,310,166,166,166,166,166,166,166,166,166,166,166,166,308,309,309,310,166,166,166,166,166,166,166,166,166,166,166,166,166,166,166,166,166,166
166,166,166,166,166,166,166,166,166,272,272,166,166,166,308,309,309,309,309,309,309,309,310,166,166,166,252,166,166,308,309,309,310,274,270,274,274,308,309,309,309,309,309,309,309,310,166,166,166,166,166,166,166,166,166,274,274,274,308,309,309,310,166,274,166,166,166,166,166,166,166,166,166,252,166,166,166,166,166,166
166,166,166,166,166,166,166,166,166,166,272,166,166,166,308,309,309,309,309,309,309,309,310,166,166,166,166,166,166,308,309,309,310,274,274,274,274,308,309,309,309,309,309,309,309,310,166,166,166,166,166,166,252,274,274,274,274,274,308,309,309,310,166,274,166,166,166,166,166,166,166,166,166,166,166,166,166,166,166,166
166,166,166,166,166,166,166,166,166,166,272,272,166,166,330,331,331,331,331,309,309,309,310,166,166,166,166,166,166,308,309,309,310,274,274,274,274,330,331,331,331,331,309,309,309,310,166,270,270,166,166,166,274,274,274,274,274,274,308,309,309,310,166,274,166,271,166,166,166,166,166,166,166,166,166,166,166,166,166,166
166,166,166,166,166,166,166,166,166,166,166,272,166,166,166,166,166,166,166,308,309,309,309,287,287,287,287,287,287,309,309,309,310,274,252,274,274,274,274,274,274,274,308,309,309,310,270,270,166,166,166,166,286,287,287,287,287,287,309,309,309,310,166,274,166,271,166,166,166,166,166,166,166,166,166,166,166,166,166,166
166,166,166,166,166,166,166,166,166,166,166,166,166,166,166,166,166,166,166,308,309,309,309,309,309,309,309,309,309,309,309,309,310,274,274,274,274,274,270,270,274,274,308,309,309,310,270,166,166,166,166,166,308,309,309,309,309,309,309,309,309,310,166,274,166,166,271,166,166,166,166,166,166,166,166,166,166,166,166,166
166,166,166,166,166,166,166,166,166,166,166,166,166,166,166,272,272,272,166,308,309,309,309,309,309,309,309,309,309,309,309,309,310,274,274,274,274,272,274,270,274,274,308,309,309,310,166,166,166,166,166,166,308,309,309,309,309,309,309,309,309,310,166,274,166,166,271,271,166,166,166,166,166,166,166,166,166,166,166,166
166,166,166,166,166,166,166,166,166,166,166,166,166,166,272,272,166,252,166,308,309,309,309,331,331,331,331,331,331,309,309,309,310,274,274,274,274,272,272,274,274,274,308,309,309,310,166,274,252,274,274,274,330,331,331,331,331,331,309,309,309,310,166,252,166,166,166,166,166,166,166,166,166,166,166,166,166,166,166,166
166,166,166,166,166,166,166,166,166,166,166,166,166,166,166,166,166,166,166,308,309,309,310,166,166,166,166,166,166,308,309,309,309,287,287,287,288,274,272,274,274,274,308,309,309,310,166,274,274,274,274,274,274,274,274,166,166,166,308,309,309,310,166,274,166,166,166,166,166,271,166,166,166,166,166,166,166,166,166,166
166,166,166,166,166,166,166,166,166,166,166,166,166,252,166,166,166,166,166,308,309,309,310,166,166,166,166,166,166,308,309,309,309,309,309,309,310,270,272,274,252,274,308,309,309,310,166,274,274,274,274,274,272,272,274,274,274,274,308,309,309,310,166,274,166,166,166,166,166,271,166,166,166,166,166,166,166,166,166,166
166,166,166,166,166,166,166,166,166,166,166,166,166,166,166,166,166,166,166,308,309,309,310,166,166,166,166,166,166,308,309,309,309,309,309,309,310,270,270,274,274,274,308,309,309,309,287,287,287,287,288,274,274,272,272,270,270,274,308,309,309,310,166,274,166,166,166,166,166,271,166,166,166,166,166,166,166,166,166,166
166,166,166,166,166,166,166,166,271,166,166,166,166,272,166,166,166,166,166,308,309,309,310,166,166,166,166,166,166,308,309,309,309,331,331,331,332,274,270,270,274,274,308,309,309,309,309,309,309,309,310,274,274,274,274,274,270,274,308,309,309,310,166,274,166,166,166,166,271,271,166,166,166,166,166,166,166,166,166,166
166,166,166,166,166,166,166,166,271,166,166,166,166,272,166,166,166,166,166,308,309,309,310,166,252,271,166,166,166,308,309,309,310,274,274,274,274,274,274,274,274,274,308,309,309,309,309,309,309,309,310,274,274,274,274,274,270,274,308,309,309,310,166,274,166,166,166,166,271,272,166,166,166,166,166,166,166,166,166,166
166,166,166,166,166,166,166,166,271,166,166,166,166,272,286,287,287,287,287,309,309,309,310,166,166,271,166,166,166,308,309,309,310,274,274,274,252,274,274,274,274,274,308,309,309,309,331,331,331,331,332,274,274,274,274,274,274,274,308,309,309,310,166,274,166,166,166,272,272,272,166,166,166,166,166,166,166,166,166,166
166,166,166,166,166,166,166,166,271,166,166,166,166,272,308,309,309,309,309,309,309,309,310,166,166,271,271,166,166,308,309,309,310,274,274,274,274,274,274,274,274,274,308,309,309,310,166,274,274,274,274,274,274,274,252,274,274,274,308,309,309,310,166,274,166,166,272,272,271,166,166,166,166,166,166,166,166,166,166,166
166,166,166,166,166,166,166,252,271,166,166,166,272,272,308,309,309,309,309,309,309,309,310,166,166,166,166,166,166,308,309,309,309,287,287,287,287,287,287,287,287,287,309,309,309,310,166,274,274,274,274,272,274,274,274,274,274,274,308,309,309,310,166,274,166,166,272,166,166,166,166,166,166,166,166,166,166,166,166,166
166,166,166,166,166,166,166,166,166,166,166,166,272,166,330,331,331,331,331,309,309,309,310,166,166,166,166,166,166,308,309,309,309,309,309,309,309,309,309,309,309,309,309,309,309,310,166,274,274,274,272,272,274,274,274,274,274,274,308,309,309,310,166,274,166,166,166,166,166,166,166,166,166,166,166,166,166,166,166,166
166,166,166,166,166,166,166,166,166,166,166,272,272,166,166,166,166,166,166,308,309,309,310,166,166,270,166,166,166,308,309,309,309,309,309,309,309,309,309,309,309,309,309,309,309,310,166,274,272,272,272,274,270,274,286,287,287,287,309,309,309,310,166,274,166,166,166,166,166,166,166,166,166,166,166,166,166,166,166,166
166,166,166,166,166,166,166,166,166,166,272,272,166,166,166,166,166,166,166,308,309,309,310,166,166,270,166,166,166,330,331,331,331,331,331,331,309,309,309,309,331,331,331,331,331,332,166,274,274,274,274,270,270,274,308,309,309,309,309,309,309,310,166,274,166,166,252,166,166,166,166,166,166,166,166,166,166,166,166,166
166,166,166,166,166,166,166,166,166,166,166,166,166,166,166,166,166,166,166,308,309,309,310,166,252,270,166,166,166,166,166,166,166,166,166,166,308,309,309,310,166,166,166,166,166,166,166,166,274,274,274,270,274,274,308,309,309,309,309,309,309,310,166,274,166,166,166,166,166,166,166,166,166,166,166,166,166,166,166,166
166,166,166,166,166,166,166,166,166,166,166,166,166,166,166,166,166,166,166,308,309,309,310,166,166,270,166,166,166,166,166,166,274,274,274,274,308,309,309,310,166,166,166,166,274,252,274,274,274,252,274,270,274,274,330,331,331,331,331,331,331,332,166,166,166,166,166,166,166,166,166,166,166,166,166,166,166,166,166,166
166,166,166,166,166,166,166,166,166,166,166,166,166,166,166,166,166,166,166,308,309,309,310,166,166,271,270,166,166,271,271,166,274,274,274,274,308,309,309,310,274,274,274,274,274,274,274,274,274,274,274,274,274,274,166,166,166,166,166,166,166,272,272,166,166,166,166,166,166,166,166,166,166,166,166,166,166,166,166,166
166,166,166,166,166,166,166,166,166,166,166,166,166,166,166,272,272,166,166,308,309,309,310,166,166,271,271,166,166,166,271,271,274,274,274,274,308,309,309,309,287,287,287,287,288,274,274,274,274,274,274,274,274,274,274,274,274,274,274,274,274,274,272,272,272,272,272,166,166,166,166,166,166,166,166,166,166,166,166,166
166,166,166,166,166,166,166,166,166,166,166,166,166,166,166,166,272,166,166,308,309,309,310,166,166,166,271,271,271,271,166,271,274,274,274,274,308,309,309,309,309,309,309,309,310,274,274,274,274,274,252,274,38,56,56,56,56,56,56,56,56,39,274,274,166,166,272,272,166,166,166,166,166,166,166,166,166,166,166,166
166,166,166,166,166,166,166,166,166,166,166,166,166,166,166,166,252,166,166,308,309,309,310,166,166,166,166,166,166,166,252,166,271,270,166,166,308,309,309,309,309,309,309,309,310,166,166,166,166,166,166,38,57,23,23,23,23,23,23,23,23,55,56,39,166,166,166,166,166,166,166,166,166,166,166,166,166,166,166,166
166,166,166,166,166,166,166,166,166,166,166,166,166,166,166,166,166,166,166,308,309,309,310,166,166,166,166,166,166,166,166,166,166,270,166,166,330,331,331,331,331,331,331,331,332,166,166,166,166,166,38,57,23,23,23,23,23,23,23,23,23,23,23,55,39,166,166,166,166,166,166,166,166,166,166,166,166,166,166,166
166,166,166,166,166,166,166,166,166,271,271,166,166,166,166,166,166,166,166,308,309,309,310,166,166,166,166,166,166,166,166,166,166,166,166,166,166,166,166,166,166,166,166,166,166,166,166,166,166,166,35,23,23,23,23,23,23,23,23,23,23,23,23,23,33,166,166,166,166,166,166,166,166,166,166,166,166,166,166,166
166,166,166,166,166,166,166,166,166,271,166,166,166,252,166,166,166,166,166,308,309,309,309,287,287,287,287,287,287,287,287,287,287,287,287,310,166,166,166,166,166,166,166,166,166,166,166,166,166,166,35,23,23,23,23,23,23,23,23,23,23,23,23,23,33,166,166,166,166,166,166,166,166,166,166,166,166,166,166,166
166,166,166,166,166,166,166,166,166,271,272,272,272,166,166,166,166,166,166,308,309,309,309,309,309,309,309,309,309,309,309,309,309,309,309,310,166,166,271,271,271,166,166,166,166,166,270,270,166,166,35,23,23,23,23,23,23,23,23,23,23,23,23,23,33,252,166,166,166,166,166,166,166,166,166,166,166,166,166,166
166,166,166,166,166,166,166,272,272,272,272,166,166,166,166,166,166,166,166,308,309,309,309,309,309,309,309,309,309,309,309,309,309,309,309,310,166,166,166,270,252,271,271,166,166,166,270,166,252,166,35,23,23,23,23,23,23,23,23,23,23,23,23,23,33,166,166,166,166,166,166,166,166,166,166,166,166,166,166,166
166,166,166,166,166,166,272,272,271,166,166,166,166,166,166,166,166,166,166,308,309,309,309,331,331,331,331,331,331,331,331,331,309,309,309,310,166,166,166,270,270,166,271,271,166,166,270,166,166,166,35,23,23,23,23,23,23,23,23,23,23,23,23,23,33,166,166,166,166,166,166,166,166,166,166,166,166,166,166,166
166,166,166,166,166,166,166,166,271,166,166,166,166,286,287,287,287,287,287,309,309,309,310,166,166,166,166,166,166,166,166,166,308,309,309,310,166,166,166,166,270,270,270,166,166,166,166,166,166,166,35,23,23,23,23,23,23,23,23,23,23,23,23,23,33,166,166,166,166,166,166,166,166,166,166,166,166,166,166,166
166,166,166,166,166,166,166,166,252,166,166,166,166,308,309,309,309,309,309,309,309,309,310,166,166,166,166,166,166,166,166,166,308,309,309,310,166,166,166,166,166,166,166,252,166,166,166,166,166,166,60,12,13,23,23,23,23,23,23,23,23,23,23,11,61,166,166,166,166,166,166,166,166,166,166,166,166,166,166,166
166,166,166,166,166,166,166,271,271,166,166,166,166,308,309,309,309,309,309,309,309,309,310,166,166,166,166,166,166,166,166,166,308,309,309,310,166,166,166,166,166,166,166,166,166,166,166,166,166,166,166,166,35,23,23,23,23,23,23,23,23,23,23,55,56,39,166,166,166,166,166,166,166,166,166,166,166,166,166,166
166,166,166,166,166,166,166,271,166,166,166,166,166,330,331,331,331,331,331,331,331,331,332,166,166,252,166,166,272,166,166,166,308,309,309,310,166,166,166,166,166,166,166,166,166,166,166,166,166,166,166,166,60,13,23,23,23,23,23,23,23,23,23,23,23,33,270,166,166,166,166,166,166,166,166,166,166,166,166,166
166,166,166,166,166,166,166,166,166,166,166,272,166,166,166,166,166,166,166,166,166,166,166,166,166,166,166,166,272,272,166,166,308,309,309,309,287,287,287,287,287,287,287,287,287,287,287,287,287,287,287,287,287,287,293,23,23,23,23,23,23,23,23,23,23,33,270,166,166,166,166,166,166,166,166,166,166,166,166,166
166,166,166,166,166,166,166,166,166,166,166,272,272,166,166,166,166,166,166,166,166,166,166,166,166,166,272,166,166,272,272,166,308,309,309,309,309,309,309,309,309,309,309,309,309,309,309,309,309,309,309,309,309,309,315,23,23,23,23,23,23,23,23,23,23,33,166,166,166,166,166,166,166,166,166,166,166,166,166,166
166,166,166,166,166,166,166,166,166,166,166,166,166,272,272,272,272,272,272,272,166,166,166,271,271,271,272,271,166,166,272,166,308,309,309,309,309,309,309,309,309,309,309,309,309,309,309,309,309,309,309,309,309,309,337,23,23,23,23,23,23,23,23,23,23,33,166,166,166,166,166,166,166,166,166,166,166,166,166,166
166,166,166,166,166,166,166,166,166,166,166,166,166,166,166,166,166,252,166,166,166,166,166,166,166,166,272,166,166,166,166,166,330,331,331,331,331,331,331,331,331,331,331,331,331,331,331,331,331,331,331,331,331,331,359,23,23,23,23,23,23,23,23,23,23,33,166,166,166,166,166,166,166,166,166,166,166,166,166,166
166,166,166,166,166,166,166,166,166,166,166,166,166,166,166,166,166,166,166,166,166,166,166,166,166,166,272,272,252,166,166,166,166,166,166,166,166,166,166,166,166,166,166,166,166,166,166,166,166,166,166,166,166,166,35,23,23,23,23,23,23,23,23,23,23,33,166,166,166,166,166,166,166,166,166,166,166,166,166,166
166,166,166,166,166,166,166,166,166,166,166,166,166,166,166,166,166,166,166,166,166,166,166,166,166,166,166,166,166,166,166,166,272,166,166,166,166,166,166,166,166,166,166,166,166,166,166,166,166,166,166,252,166,166,35,23,23,23,23,23,23,23,23,23,23,33,166,166,166,166,166,166,166,166,166,166,166,166,166,166
166,166,166,166,166,166,166,166,166,166,166,166,166,166,166,166,166,166,166,166,166,166,166,166,166,166,166,166,166,166,166,166,272,166,166,271,271,166,166,166,166,272,272,272,166,166,166,166,166,166,166,166,166,166,35,23,23,23,23,23,23,23,23,23,23,33,166,166,166,166,166,166,166,166,166,166,166,166,166,166
166,166,166,166,166,166,166,166,166,166,166,166,166,166,166,166,166,166,166,166,166,166,166,166,166,166,166,166,166,166,271,271,272,271,271,271,166,166,252,166,166,166,166,272,272,272,166,166,271,272,271,166,166,166,60,13,23,23,23,23,23,23,23,23,23,33,166,166,166,166,166,166,166,166,166,166,166,166,166,166
166,166,166,166,166,166,166,166,166,166,166,166,166,166,166,166,166,166,166,166,166,166,166,166,166,166,166,166,166,166,271,166,272,166,166,166,166,166,166,166,166,166,166,166,271,271,271,271,272,272,166,166,166,166,166,60,12,12,12,12,12,12,12,12,12,61,166,166,166,166,166,166,166,166,166,166,166,166,166,166
166,166,166,166,166,166,166,166,166,166,166,166,166,166,166,166,166,166,166,166,166,166,166,166,166,166,166,166,166,166,166,166,272,166,166,166,166,166,166,166,166,166,166,271,271,166,166,166,272,166,166,166,166,166,166,166,166,166,166,166,166,166,166,166,166,166,166,166,166,166,166,166,166,166,166,166,166,166,166,166
166,166,166,166,166,166,166,166,166,166,166,166,166,166,166,166,166,166,166,166,166,166,166,166,166,166,166,166,166,166,166,166,272,166,166,166,166,166,166,166,166,166,166,166,166,166,166,166,272,166,166,166,166,166,166,166,166,166,166,166,166,166,166,166,166,166,166,166,166,166,166,166,166,166,166,166,166,166,166,166
166,166,166,166,166,166,166,166,166,166,166,166,166,166,166,166,166,166,166,166,166,166,166,166,166,166,166,166,166,166,166,166,166,166,166,166,166,166,166,166,166,166,166,166,166,166,166,166,166,166,166,166,166,166,166,166,166,166,166,166,166,166,166,166,166,166,166,166,166,166,166,166,166,166,166,166,166,166,166,166
166,166,166,166,166,166,166,166,166,166,166,166,166,166,166,166,166,166,166,166,166,166,166,166,166,166,166,166,166,166,166,166,166,166,166,166,166,166,166,166,166,166,166,166,166,166,166,166,166,166,166,166,166,166,166,166,166,166,166,166,166,166,166,166,166,166,166,166,166,166,166,166,166,166,166,166,166,166,166,166
166,166,166,166,166,166,166,166,166,166,166,166,166,166,166,166,166,166,166,166,166,166,166,166,166,166,166,166,166,166,166,166,166,166,166,166,166,166,166,166,166,166,166,166,166,166,166,166,166,166,166,166,166,166,166,166,166,166,166,166,166,166,166,166,166,166,166,166,166,166,166,166,166,166,166,166,166,166,166,166
166,166,166,166,166,166,166,166,166,166,166,166,166,166,166,166,166,166,166,166,166,166,166,166,166,166,166,166,166,166,166,166,166,166,166,166,166,166,166,166,166,166,166,166,166,166,166,166,166,166,166,166,166,166,166,166,166,166,166,166,166,166,166,166,166,166,166,166,166,166,166,166,166,166,166,166,166,166,166,166
166,166,166,166,166,166,166,166,166,166,166,166,166,166,166,166,166,166,166,166,166,166,166,166,166,166,166,166,166,166,166,166,166,166,166,166,166,166,166,166,166,166,166,166,166,166,166,166,166,166,166,166,166,166,166,166,166,166,166,166,166,166,166,166,166,166,166,166,166,166,166,166,166,166,166,166,166,166,166,166
166,166,166,166,166,166,166,166,166,166,166,166,166,166,166,166,166,166,166,166,166,166,166,166,166,166,166,166,166,166,166,166,166,166,166,166,166,166,166,166,166,166,166,166,166,166,166,166,166,166,166,166,166,166,166,166,166,166,166,166,166,166,166,166,166,166,166,166,166,166,166,166,166,166,166,166,166,166,166,166
166,166,166,166,166,166,166,166,166,166,166,166,166,166,166,166,166,166,166,166,166,166,166,166,166,166,166,166,166,166,166,166,166,166,166,166,166,166,166,166,166,166,166,166,166,166,166,166,166,166,166,166,166,166,166,166,166,166,166,166,166,166,166,166,166,166,166,166,166,166,166,166,166,166,166,166,166,166,166,166
166,166,166,166,166,166,166,166,166,166,166,166,166,166,166,166,166,166,166,166,166,166,166,166,166,166,166,166,166,166,166,166,166,166,166,166,166,166,166,166,166,166,166,166,166,166,166,166,166,166,166,166,166,166,166,166,166,166,166,166,166,166,166,166,166,166,166,166,166,166,166,166,166,166,166,166,166,166,166,166
166,166,166,166,166,166,166,166,166,166,166,166,166,166,166,166,166,166,166,166,166,166,166,166,166,166,166,166,166,166,166,166,166,166,166,166,166,166,166,166,166,166,166,166,166,166,166,166,166,166,166,166,166,166,166,166,166,166,166,166,166,166,166,166,166,166,166,166,166,166,166,166,166,166,166,166,166,166,166,166
166,166,166,166,166,166,166,166,166,166,166,166,166,166,166,166,166,166,166,166,166,166,166,166,166,166,166,166,166,166,166,166,166,166,166,166,166,166,166,166,166,166,166,166,166,166,166,166,166,166,166,166,166,166,166,166,166,166,166,166,166,166,166,166,166,166,166,166,166,166,166,166,166,166,166,166,166,166,166,166
